800
11
XXXXXXXXXXX
XA.QQ..Q.EX
X.XQX.XQX.X
XQQQ.Q..QQX
X.XQX.X.XQX
X..QQQQQQQX
X.X.X.X.X.X
XQQQQQ..QQX
X.XQX.X.X.X
XI.Q...Q.MX
XXXXXXXXXXX