800
11
XXXXXXXXXXX
XA.......EX
X.X.X.X.X.X
X.........X
X.X.X.X.X.X
X.........X
X.X.X.X.X.X
X.........X
X.X.X.X.X.X
XI.......MX
XXXXXXXXXXX